/* I think this stuff is for subtitles - Milo --- and what you see when you click on a beacon - Goth */
SCAVBASE_MSG	_("Scavenger Base")
RETREAT_MSG		_("Safe Zone")
OBJECTIVEA1_MSG	_("Retreat Location")
OBJECTIVEA2_MSG	_("Scavenger Base - Objective 1")
OBJECTIVEA3_MSG	_("Scavenger Base - Objective 2 East")
OBJECTIVEA3B_MSG	_("Scavenger Base - Objective 2 West")
OBJECTIVEA4_MSG	_("Scavenger Base - Objective 3 North")
OBJECTIVEA4B_MSG	_("Scavenger Base - Objective 3 South")
OBJECTIVEA5_MSG	_("North Pass - Operations Area 2")
OBJECTIVEB1_MSG	_("Objective 1")
OBJECTIVEB2_MSG	_("Objective 2")
OBJECTIVEB3_MSG	_("Objective 3")
OBJECTIVEB4_MSG	_("Objective 4")
OBJECTIVEB5_MSG	_("Rally Point")
OBJECTIVEB6_MSG	_("Objective 5")
OBJECTIVEB7_MSG	_("Gateway to Operations Area 3")
OBJECTIVEB8_MSG	_("Northeast Scavenger Base")
OBJECTIVEB9_MSG	_("Team 2 Rendevous Point")
OBJECTIVEB92_MSG	_("Transport Two")
OBJECTIVEB9THREADM4		_("Gateway to Operations Area 4")
OBJECTIVEB9THREADM3		_("Gateway to Operations Area 3")
OBJECTIVEGOAROUND1		_("Waypoint 1")
OBJECTIVEGOAROUND2		_("Waypoint 2")
OBJECTIVEGOAROUND3		_("Waypoint 3")
OBJECTIVECATCHARIDE		_("Pickup Location")
OBJECTIVEC1_MSG	_("Objective 1")
OBJECTIVEC2_MSG	_("Objective 2")
OBJECTIVEC3_MSG	_("Objective 3")
OBJECTIVEC4_MSG	_("Objective 4")
OBJECTIVEC5_MSG	_("Objective 5")
OBJECTIVEC6_MSG	_("Objective 6")
OBJECTIVEC7_MSG	_("Old NASDA Base")
OBJECTIVEC7B_MSG	_("Abandoned NASDA Base")
OBJECTIVEC8_MSG	_("Objective 8")
OBJECTIVEC8B_MSG _("Staging Point")
OBJECTIVEC9_MSG	_("Next Objective")
OBJECTIVED1_MSG	_("Gateway to next mission area")
OBJECTIVED2_MSG	_("Objective 2")
OBJECTIVED3_MSG	_("Objective 3")
OBJECTIVED4_MSG	_("Objective 4")
OBJECTIVED5_MSG	_("Objective 5")
OBJECTIVED6_MSG	_("Objective 6")
OBJECTIVED7_MSG	_("Objective 7")
OBJECTIVED8_MSG	_("Objective 8")
OBJECTIVED9_MSG	_("Objective 9")
OBJECTIVED10_MSG	_("Objective 10")
OBJECTIVED11_MSG	_("Objective 11")
OBJECTIVED12_MSG	_("Objective 12")
OBJECTIVED13_MSG	_("Escape Location")
OBJECTIVED14_MSG	_("Nexus Base North")
OBJECTIVED15_MSG	_("Scavenger Base")
OBJECTIVEE1_MSG	_("Nexus Prime - Primary Objective")
END_MSG				_("Mission Failed")
WIN_MSG				_("Mission Successful")
